1111111111111111111111111
10E0000000000P00000000001
1110000000000000000000001
1100C00000000000000000001
1110000000000000000000001
1100C00000000000000000001
1100000000000000000000011
1110000000000000000000001
1100C00000000000000000001
1110000000000000000000001
1100C00000000000000000001
1100C00000000000000000001
1111111111111111111111111